########################################
##u#h#h#h################..............#
#ap......################..............#
##.......################..............#
#a..........#############..............#
##.......##..############..............#
#a.......##...###########..............#
##......###....##########..............#
#a......###....##########..............#
###....###......#########..............#
####..####.####.#########..............#
##########.####.#########..............#
##########.####.#########..............#
##########.#C.#.#########..............#
##########.#..#.#########..............#
##########.#.##.#########..............#
##########I.....#########..............#
########ww#....##########..............#
#######wwww....##########..............#
##...wwwwwwww...#########..............#
#..wwwwwwwwwwww..########..............#
#.wwwwwwwwwwwwww..#######..............#
#wwwwwwwwwwwwwwww..######..............#
wwwwwwwwwwwwwwwwww..#####..............#
wwwwwwwwwwwwwwwwwww..####..............#
wwwwwwwwwwwwwwwwwwww..###..............#
wwwwwwwwwwwwwwwwwwwww..##..............#
wwwwwwwwwwwwwwwwwwwww..##..............#
wwwwwwwwwwwwwwwwwwww...##..............#
#wwwwwwwwwwwwwwwwww....#####...........#
##wwwwwwwwwwwwwww##.....O..#...........#
###wwwwwwwwwwwww###....#####...........#
#####wwwwwwwww#####....##..............#
######.wwwwww######....##..............#
########wwww#######....##..............#
#########ww########....##..............#
#.........d.......#....##..............#
#.........P.......#....##..............#
#.................#....##..............#
#.................#....................#
#.................#....................#
########################################
#.................#..#.................#
#.................#....................#
#.................#....................#
#.................#....................#
#.................#....................#
#.................#....................#
#.................#....................#
#.................#....................#
#.................#....................#
#.................#....................#
#.................#....................#
#.................#....................#
##................#....................#
#.................#....................#
###################....................#
########################################
........................................
tile_set: forest
music: TitleTheme
