###########################################################
#u.........######.###########.###################d#########
#p...#..#..##.O............................#.....P.......##
#.#........##.#######.###############.####................#
#....#..#..##.#######....C###################.............#
#..#.......##.#################....#.##############.......#
#..........##...................##.#.###########C########.#
#.#...#..#.##.#################.##.#.#...#######....#O....#
#..........##.................#....#......#########.#####.#
#...#.##...####################.####.#.....##........O....#
#..........##......#.#........#.#C##.#.###..#############.#
#####.#######.#.##...#.#.####.#.#.##.#.####..########O....#
#..C#.#C...##.#.C#.#.#.#......#.#.##.#.#####.############.#
#...#.#....##.####.#.#.#.######.#.##.#.#####.#.##########.#
#.###.###.###..I...#...#........#....#.#####.#......#####.#
#....O.....###.#####################.#.#####.#.###.#..###.#
#####.#######....O...........#.....#.#.#####.#.##.....###.#
#..........#########.#########.###.#.#.#####.#.##.#.#..##.#
##.##########.#.I..#.......#...###.#.#.#####.#.##......##.#
#I.........##...##.#######.#.#.###.#.#.#####.#.###.#..#.#.#
#..........##.#.##.........#.#.###.#.#.......#.##.......#.#
#########..##.#.##.#########.#.#C#.#.###.#####.##..#.#..#.#
#C##....#..##.#....#....C###.#.#.#.#.###.##C##.##.......#.#
#.##.##.#..##.######.#######.#I#.#.#I#...#..##.##.#.#.#.#.#
#....##.#..##.O..............#.#.#...#.###.###.##.......#.#
##.#.##.#..###################.....#.#...O.....##..#.#..#.#
#C##.I..#..######################################.......#.#
#..###.##..#.......#.############################.#.#.#.#.#
#....#.....#.#####.#.#....I...#....I..#.....I...#.......#.#
##.#######.#.###C#.#.#.######...#####...###.###....#.#..#.#
#....O...#.#.....#.....###C.....#C.##...##C.###.#.......#.#
####.#####.#.#####.#.#.######...##.##...#######.#.#.#.#.#.#
#..........#....I..#.#........#.......#.........#.......#.#
#.##################.################################.###.#
#..........#........O......#.#...############...#.......#.#
##########.###.#############.#.#.###########..#.#.#######.#
#....#.......#...............#.#.##########..##.#.#######.#
#.##...#####################.#.#..########..###.#.#######.#
#.##.##..#.....#############.#.##.#######..####.#.#######.#
#.##.#...#.............#...#.#.#...#####..#####.#.#######.#
#.##.#.#.###.#####...#.....#.#.#.#.####..######.#.###.O...#
#...I#.#...#.######..###...#.#.#.#.###..#######.#.#######.#
##.###.#.#.#...O..##...#I..#.#.#I#.##..####.#.#.#.###.O...#
#I...#.#.#.####.#..#...##.##.#.#.#....#####.#.#...#######.#
#.##.#.#.#.###C..#..##..#C.#.#.#...########.#.#.#####.O...#
#.##.#.#.#.###...##...#..###.#.############.#.###########.#
#.##.#.#.#.####.#####.#...##.#............................#
#.##.#.#.#.#...O....#..##.##.##############.#.#############
#.##...#.#.####.######..#....##############I#I#############
#....#.#.#..........###...#################.#.#############
###########################################################
###########################################################
tile_set: cave
music: TitleTheme
