###########################################################
#u.........######.###########.###################d#########
#p...#..#..##.O............................#wwwwwPwwwwwww##
#.#........##.#######.###############.####.........wwwwwww#
#....#..#..##.#######....C###################wwwww..wwwwww#
#..#.......##.#################....#.##############.......#
#..........##...................##.#.###########C########.#
#.#...#..#.##.#################.##.#.#...#######....#O....#
#..........##.................#....#......#########.#####.#
#...#.##...####################.####.#.....##........O....#
music: TitleTheme
