##d#########
#.p........#
#..........#
#..........#
#....w.....#
#....www...#
#...www....#
#.....w....#
#..........#
#..........#
#..........#
############
            
tile_set: fortress
music: TitleTheme
